########
#      #
# .XXB&#
#      #
#####  #
########
