########
#  &  ##
# ##B ##
#  .X  #
##B #  #
##   X.#
########