######
#&  ##
#.BX #
#  # #
#    #
######
