######
# & ##
#...##
#BBB##
#    #
#    #
######