########
#  #####
# BB B #
#      #
## ## ##
#...#&##
# ### ##
#      #
#  #   #
########