#######
###  ##
#& .B##
#   B #
# #.  #
#     #
#######
