#######
#.##  #
#B    #
#.X&B #
#. B ##
#######