#########
#     ###
#  &BB..#
#### ## #
###     #
###  ####
###  ####
#########