########
#.B&  ##
###   ##
#.##  ##
# #   ##
#B XB  #
#   .  #
######## 