#########
# . . . #
#   B   #
#   B   #
#   B   #
#       #
#   &   #
#########
