#########
#   #   #
#   B &.#
#   #   #
#   #   #
#########