######
#    #
# #& #
# BX #
# .X #
#    #
######