###########
###     ###
# B B   ###
# ### #####
# & . .   #
#   ###   #
###########