########
#.   B #
# B   .#
# &   B#
#      #
#     .#
########