#######
#  ####
# . . #
# BBX&#
##    #
#######
