######
#    #
# #. #
#&B  #
### ##
# B  #
# #  #
#  . #
######