########
#  . . #
#    # #
## # # #
##  B  #
##  B& #
##     #
########
