#########
#    ####
# ## ####
#  .B.###
# #B&B###
# #.B.  #
# # ### #
#       #
#########