########
#### &##
####   #
#. #BB #
#     ##
#.  B###
##.  ###
########