#########
##  ...##
## & ####
###B    #
#   #B# #
# B #   #
#   #####
#########