######
#.X  #
#.B  #
#&B  #
###  #
######