##########
###.     #
#    B # #
#.   B   #
#    B B##
#   . .&##
##########