##########
##&    ###
##B### B #
#    B   #
# ..#B  ##
##..#   ##
##########