########
#  #####
#      #
#      #
## ## ##
#...# ##
# ### ##
#      #
#  #   #
########