#########
# & #   #
# B B   #
##B### ##
#  ...  #
#   #   #
######  #
#########