#######
#&   ##
# BB  #
# #. .#
#     #
#######
