##########
###  #####
#  B  &..#
# B    # #
### #### #
###      #
##########