########
##& ####
## B  ##
### # ##
#.# #  #
#.B  # #
#.   B #
########