#######
#   ###
# & ###
# BB###
##. . #
##    #
#######