######
# .###
#  ###
#X&  #
#  B #
#  ###
######
