#########
######&##
#    .X #
#   #   #
#####B# #
#####   #
#########