########
### ..&#
### BB #
#### ###
#### ###
#    ###
# #   ##
#   # ##
###   ##
########
