########
#   .. #
#  &BB #
##### ##
####  ##
####  ##
####  ##
########