#########
###  ####
#       #
#&BXXX. #
#       #
#########