######
#&  ##
##BB##
#.   #
#  . #
#  ###
######