#########
###  ####
#     B #
# #  #B #
# . .#& #
#########