############
#    ###   #
# BB     #&#
# B #...   #
#   ########
############