#########
###### &#
######  #
###### .#
#   B  .#
#  BB# .#
#    ####
###  ####
#########